1 1 1 1 1 1 1 1 1 1 1 1 1 1 1 1 1 1 1 1 1 1 1 1 1 1 1 1 1 1 1 1 1 1 1 1 1 1 1 1 1 1 1 1 1 1 1 1 1 1 1 1 1 1 1 1 1 1 1 1
1 0 0 0 0 11 0 0 0 0 0 3 0 0 0 0 0 0 0 0 0 0 2 0 0 0 0 5 0 0 0 0 0 0 0 7 1 0 0 0 0 0 0 0 0 0 0 0 0 2 0 0 5 5 6 5 5 0 0 1
1 0 0 0 0 5 0 0 0 0 0 0 0 0 0 0 0 6 0 0 0 0 1 0 0 0 5 5 5 0 0 0 0 0 0 0 1 11 0 0 0 0 0 0 0 0 0 0 0 2 0 0 6 5 8 5 6 0 0 1
1 0 0 0 5 5 5 0 0 0 0 4 0 0 0 0 6 6 6 0 0 0 2 0 0 5 5 6 5 5 0 0 0 0 0 0 1 0 0 0 0 0 0 0 0 0 0 0 0 2 9 0 5 5 6 5 5 0 0 1
1 0 0 5 5 6 5 5 0 0 0 0 0 0 0 6 6 6 6 6 0 0 1 0 0 0 5 5 5 0 12 0 0 0 0 0 1 0 5 0 0 0 0 1 1 1 1 1 1 1 0 2 0 1 0 2 0 1 0 1
1 0 0 0 5 5 5 0 0 0 0 3 0 0 0 0 6 6 6 0 0 0 1 0 0 0 0 5 0 0 0 0 0 0 0 0 1 0 5 5 5 0 0 2 0 0 0 0 11 0 0 5 0 0 0 0 0 0 0 1
1 0 12 0 0 5 0 0 0 0 0 0 0 0 0 0 0 6 0 0 0 0 1 0 0 0 0 0 0 0 0 0 0 0 0 0 0 5 5 6 5 5 0 1 7 0 0 0 0 0 5 5 5 0 0 0 0 0 0 1
1 0 0 0 0 0 0 0 0 0 0 4 0 0 0 0 0 0 0 0 0 0 0 0 0 12 0 0 0 0 0 0 0 0 0 0 0 0 5 5 5 0 0 2 0 0 0 0 0 5 5 6 5 5 0 0 0 0 0 1
1 0 0 0 0 0 0 0 0 0 0 0 0 0 0 0 0 0 0 0 0 0 0 0 0 0 0 0 0 0 0 0 0 0 0 0 0 0 0 5 0 0 0 1 0 0 0 0 0 0 5 5 5 0 0 0 0 0 7 1
1 0 2 0 1 0 3 0 1 0 1 0 1 0 1 0 0 0 0 0 0 0 0 0 0 0 0 0 0 5 0 0 0 0 0 0 0 0 0 0 0 0 13 3 0 0 0 0 0 0 0 5 0 0 0 0 0 0 0 1
1 0 0 0 0 0 0 0 5 0 11 0 0 0 0 0 0 0 0 0 0 0 0 0 0 0 0 0 5 5 5 0 0 0 0 0 0 1 1 4 1 4 1 1 0 0 0 0 0 0 0 0 0 0 0 0 13 0 0 1
1 0 0 0 0 0 0 5 5 5 0 0 0 0 0 0 0 1 0 0 0 0 0 0 0 0 0 5 5 5 5 5 0 0 0 0 12 0 0 0 0 0 0 0 0 0 0 0 1 1 1 1 1 1 1 0 0 0 0 1
1 0 0 0 0 0 5 5 6 5 5 0 0 0 0 0 0 2 0 0 0 0 0 0 0 0 5 5 5 6 5 5 5 0 0 0 0 0 0 0 0 0 0 0 0 0 0 0 1 0 6 0 6 0 6 0 6 12 6 1
1 0 0 0 0 0 0 5 5 5 0 0 12 0 0 0 0 2 0 0 0 0 0 0 0 0 0 5 5 5 5 5 0 0 0 0 0 0 0 0 0 0 0 0 0 0 0 0 1 6 0 6 0 6 0 6 0 6 0 1
1 0 0 0 0 0 0 0 5 0 0 0 0 0 0 0 0 2 0 0 0 0 0 0 1 5 0 0 5 5 5 0 0 5 1 0 0 0 0 0 0 0 0 0 0 0 0 0 2 0 6 0 6 0 6 0 6 0 6 1
1 7 0 13 0 0 0 0 0 0 0 0 0 0 0 0 0 2 0 0 0 0 0 0 1 5 0 0 0 5 0 0 0 5 1 0 0 0 0 0 0 0 0 1 5 0 0 0 2 6 0 6 12 6 0 6 0 6 0 1
1 1 1 1 1 1 1 2 2 4 4 1 1 1 1 1 1 1 0 0 0 0 1 1 1 5 0 1 1 2 1 1 0 5 1 1 1 0 0 0 0 0 0 1 5 0 0 0 2 0 6 0 6 0 6 0 6 0 6 1
1 0 0 0 0 0 0 0 0 0 0 0 0 13 0 0 0 0 0 0 0 0 5 5 5 5 1 2 2 2 2 2 1 5 5 5 5 0 0 0 0 0 0 1 5 0 0 0 2 6 0 6 0 6 0 6 0 6 0 1
1 0 0 0 12 0 0 0 0 0 0 5 0 0 0 0 0 0 0 0 0 0 0 0 0 1 2 2 2 2 2 2 2 1 0 0 0 0 0 0 0 0 0 1 5 0 0 0 1 12 6 0 6 0 6 0 6 9 6 1
1 0 0 0 0 0 0 0 0 0 5 5 5 0 0 0 0 12 0 0 0 0 0 0 0 1 6 6 1 1 1 6 6 1 0 0 0 0 0 0 0 0 0 1 5 0 0 0 1 1 1 1 1 1 1 1 1 1 1 1
1 0 0 10 0 0 0 0 0 5 5 6 5 5 0 0 0 0 0 0 0 0 13 0 0 2 6 6 6 1 6 6 6 2 0 0 0 0 0 0 0 0 0 0 0 0 0 0 0 0 11 0 0 0 0 5 5 6 5 1
1 0 0 0 0 0 0 0 0 0 5 5 5 0 0 0 0 0 0 0 0 0 0 0 0 1 2 2 2 2 2 2 2 1 0 0 0 0 0 0 0 0 0 0 0 0 0 0 12 0 0 0 0 0 5 5 5 5 5 1
1 0 0 0 0 0 0 0 11 0 0 5 0 0 0 0 0 0 0 0 0 0 0 0 0 0 1 2 2 10 2 2 1 0 0 0 0 0 0 0 0 0 0 0 0 0 0 0 0 0 0 0 0 5 5 5 6 5 5 1
1 7 12 0 0 0 0 0 0 0 0 0 0 0 0 0 0 0 0 0 0 0 5 5 5 5 0 1 2 2 2 1 0 5 5 5 0 0 0 0 0 0 0 0 0 0 0 0 0 0 0 0 0 5 7 5 5 6 5 1
1 1 1 1 1 1 2 1 1 1 1 1 1 1 4 1 1 1 1 0 0 0 1 1 1 5 0 1 0 1 0 1 0 5 1 1 1 0 0 0 0 0 0 0 0 0 0 0 0 0 0 0 0 0 5 12 5 5 5 1
1 6 0 0 0 0 0 0 0 5 0 0 0 0 0 0 0 6 1 0 0 0 0 0 1 5 0 1 0 1 0 1 0 5 1 0 0 0 0 0 0 0 0 0 0 0 0 0 0 0 0 0 0 0 0 5 5 5 10 1
1 0 0 0 0 0 0 0 5 5 5 0 0 0 0 0 0 0 1 0 0 0 0 0 1 5 0 0 0 0 0 0 0 5 1 0 0 0 0 0 0 1 1 1 1 1 1 1 1 2 2 2 2 1 1 1 1 1 1 1
1 0 0 0 0 0 0 5 5 6 5 5 0 0 0 0 0 0 1 0 0 0 0 0 0 0 0 0 0 0 0 0 0 0 0 0 0 0 0 0 0 1 0 0 0 0 0 0 5 5 5 5 5 0 11 0 0 0 0 1
1 0 0 0 0 0 0 0 5 5 5 0 0 0 0 0 0 0 1 0 0 0 0 0 0 0 0 0 0 0 0 0 0 0 0 0 0 0 0 0 0 2 0 0 0 0 0 0 0 0 0 0 0 0 0 0 0 0 0 1
1 0 0 0 0 0 0 0 0 5 0 0 0 0 0 0 0 0 1 4 1 1 4 1 0 0 0 0 0 0 0 0 0 0 0 0 0 0 0 0 0 1 0 0 0 0 0 0 0 0 0 0 0 0 0 1 5 5 5 1
1 0 0 0 12 0 0 0 0 0 0 0 0 0 0 0 0 0 0 0 0 0 0 1 1 1 1 4 4 1 1 1 0 3 0 4 0 3 0 4 0 1 0 0 0 0 0 0 0 0 0 0 0 0 0 1 5 5 5 1
1 0 0 0 0 5 0 0 0 0 0 0 0 1 0 5 5 5 0 0 0 0 0 0 0 0 0 0 0 0 13 1 0 0 0 0 0 0 0 0 0 1 0 0 0 0 0 13 0 0 0 0 0 0 0 1 7 5 5 1
1 0 0 0 5 5 5 0 0 0 0 0 0 1 0 0 0 0 0 0 0 0 0 0 0 0 0 0 0 0 0 1 0 1 0 1 0 2 0 1 0 1 0 0 0 0 0 0 1 0 0 0 0 1 1 1 1 1 1 1
1 0 0 5 5 6 5 5 11 0 0 0 0 2 0 0 0 0 0 0 0 0 0 0 0 0 0 0 0 0 0 1 0 0 0 0 0 0 0 0 0 0 0 0 0 0 0 0 1 0 0 0 0 0 0 0 0 0 0 1
1 0 0 0 5 5 5 0 0 0 0 0 0 1 0 0 0 0 12 0 0 0 0 0 0 0 0 0 12 0 0 1 0 0 0 0 0 0 0 0 0 0 0 0 0 0 0 0 1 0 0 0 0 0 0 0 0 0 0 1
1 7 0 0 0 5 0 0 0 0 0 0 0 2 13 0 0 0 0 0 0 0 0 5 5 5 5 0 0 0 0 1 0 0 0 0 0 0 0 0 0 0 0 0 0 0 0 0 1 0 0 0 0 12 0 0 0 0 0 1
1 1 2 1 1 1 1 1 1 2 1 1 1 1 0 1 0 4 0 1 7 2 0 1 0 1 1 1 1 4 1 1 1 1 1 2 1 1 1 1 1 5 1 5 1 5 3 5 1 0 0 0 0 0 0 0 0 0 0 1
1 5 5 5 5 5 5 5 0 0 0 0 0 0 0 0 0 0 0 0 0 0 0 0 0 0 0 0 0 0 0 0 0 0 0 0 1 6 5 2 0 0 0 0 0 0 0 0 1 1 1 1 0 1 0 4 0 1 1 1
1 1 1 1 1 1 1 0 0 0 0 0 5 5 5 5 5 5 5 0 0 0 0 0 0 0 0 0 0 0 0 0 0 0 0 0 1 1 1 1 1 1 0 0 0 0 0 0 1 13 5 5 5 5 5 5 5 5 5 1
1 11 5 5 5 5 1 0 0 0 0 0 0 0 0 0 0 0 0 0 0 0 0 0 0 0 0 1 1 4 4 1 1 0 0 0 0 0 0 0 0 13 0 0 0 0 0 0 1 5 5 5 5 5 5 6 5 5 5 1
1 5 5 5 5 5 1 0 0 0 0 1 4 1 2 1 0 0 3 0 0 0 0 0 0 0 0 1 0 0 0 0 1 0 0 0 0 0 0 0 0 0 0 0 0 0 0 0 1 5 5 5 5 5 6 5 5 5 5 1
1 5 5 5 5 5 1 0 0 0 0 1 5 5 5 1 0 0 12 0 0 5 5 5 0 0 0 3 0 0 0 0 3 0 0 0 1 1 1 0 0 0 0 0 0 0 0 0 1 5 5 5 5 5 5 5 5 5 5 1
1 9 5 5 5 5 2 0 0 0 0 1 7 5 5 1 0 0 0 0 0 0 0 0 0 0 0 3 7 0 0 0 3 5 5 5 1 7 5 5 5 5 5 5 5 5 5 13 1 5 5 5 5 11 5 5 5 5 5 1
1 1 1 1 1 1 1 1 1 1 1 1 1 1 1 1 1 1 1 1 1 1 1 1 1 1 1 1 1 1 1 1 1 1 1 1 1 1 1 1 1 1 1 1 1 1 1 1 1 1 1 1 1 1 1 1 1 1 1 1